NO  res/texture/foo.xpm
SO  res/texture/foo.xpm
WE  res/texture/foo.xpm
EA  res/texture/foo.xpm

F 1200,100,0
C 0,30,4 

1111111111111111111111111
1000000000110000000000001
1011000001110000000000001
1001000000000000000000001
1111111110110000011100001111111
100000000011000001110111111111111
11110111111111011100000011111
1111011111111101110101001
110000001101010111000000111111
100000000000000011000000100001
1000N0000000000011010100100011
11000001110101011111011110001
11110111 1110101 101111010001
11111111 1111111 111111111111