1111111111111111
1000000000000001
1001000000001001
1000000000000001
1000101001001001
1000010000000101
1000101001001001
1000000000000001
1000000000000001
1111111111111111