1111111111
1010000001
1001000001
1010010001
1000101001
1000010001
1000101001
1010001001
1000100001
1111111111