1111111111
1000000001
1000001001
1100000001
1011001001
1000000101
1001001001
1000000001
1000000001
1111111111