00000001111
00001110001
00110010101
01000100001
10001001111
11100001001
10111101101
10000010011
11111111110