NO res/texture/muro.xpm
EA res/texture/muro.xpm
SO res/texture/muro.xpm
WE res/texture/muro.xpm
      
C 100,150,255 
F 100,100,100

        11111111
        1W000001
        10110001
        10010001
1111111110110001
1000000000110001
1111011111111101
1111011111111101
1100000011010101
1000000000000001
1000000000000001
1100000111010101
11110111 1110101
11111111 1111111